1212121212121
2222222222222
2131415141312
2334455544332
2131415141312
2233445443322
